###########
#S....#.###
###.#...###
#...#.#.#.#
#.#.#.#.#.#
#.#.#.#.#.#
#.#.#.#.#.#
#...#.....#
###.#####E#
###########